111111
1P0C11
101001
1010C1
100001
111111