111111
1P0C01
10P001
1000E1
111111
