111111
100C01
100001
1000E1
111111
