111111
1P0C01
100001
10E0E1
111111
