111111
1P0C11
1010X1
1010C1
1000E1
111111
