111011
1P0C11
101001
1010C1
1000E1
111111