111111
1P0C11
1P1001
1010C1
1000E1
111111
