11111
1P0C1
10101
101C1
1E001
11111
