1111
1P01
1001
10C1
1001
1101
1E01
1111
