111111
1P0C01
100001
100101
100E01
111111
