111111111111111111
1P00000000100000C1
101011111010111111
101000000000000001
101111101111111011
100000101000001011
111110101011101011
1C00000000100000E1
111111111111111111
