111111111111111
1P00000C00000E1
100000000000001
111111111111111
