1111111111111
1P00000000001
10111111111C1
1000000000001
1111101111111
1C00000000001
1011111110111
100000C0000E1
1111111111111
