111111
1P1C11
100001
1010C1
1E0001
111111